     ||   ||     ||   ||
     ||   ||, , ,||   ||
     ||  (||/|/(\||/  ||
     ||  ||| _'_`|||  ||
     ||   || o o ||   ||
     ||  (||  - `||)  ||
     ||   ||  =  ||   ||
     ||   ||\___/||   ||
     ||___||) , (||___||
    /||---||-\_/-||---||\
   / ||--_||_____||_--|| \
  (_(||)-|         |-(||)_)